
##Восточная Европа и СНГ
SOU = "countries/Soviet Union.txt"
PLN = "countries/Poland.txt"
LIA = "countries/Litva.txt"
ESA = "countries/Estonia.txt"
LAA = "countries/Latvia.txt"  
BLS = "countries/Belarus.txt" 
UKN = "countries/Ukraina.txt"
GRU = "countries/Gruzia.txt"
ARN = "countries/Armenia.txt"
AZB = "countries/Azerbajan.txt"
KAH = "countries/Kazahstan.txt" 
UZK = "countries/Uzbekistan.txt"
KYS = "countries/Kirgizia.txt"
TMN = "countries/Turkmenistan.txt" 
TJK = "countries/Tajikistan.txt"
MLD = "countries/Moldavia.txt"

##Южная Европа
RMN = "countries/Romania.txt"
BLG = "countries/Bolgaria.txt"
YGS = "countries/Yugoslavia.txt"
HUG = "countries/Hungary.txt"
CZH = "countries/Czechoslovakia.txt"
GRC = "countries/Grecia.txt"
ALN = "countries/Albania.txt"
TUK = "countries/Turkey.txt"
SLN = "countries/Slovenia.txt"
XOR = "countries/Xorvatia.txt"
MAK = "countries/Makedonia.txt"

##Западная Европа
FRG = "countries/Federate Germany.txt" 




